....&&&....
.&&&..&..&.
....&...&..
.&.&...&..&
.&.&.&..&..
#&...&..&.@